
B B B B B B B B B B B B B W S S S S S S S S S S S S S S S S S S S S S S S S S S S S S S S S S S S S S S S S S S
B B B B B B B B B B B B B W S S S S S S S S S S S S S S S S S S S S S S S S S S S S S S S S S S S S S S S S S S
B B B B B B B B B B B B B W S S S S S S S S S S S S S S S S S S S S S S S S S S S S S S S S S S S S S S S S S S
B B B B B B B B B B B B B W S S S S S S S S S S S S S S S S S S S S S S S S S S S S S S S S S S S S S S S S S S
B B B B B B B B B B B B B W S S S S S S S S S S S S S S S S S S S S S S S S S S S S S S S S S S S S S S S S S S
B B B B B B B B B B B B B W S S S S S S S S S S S S S S S S S S S S S S S S S S S S S S S S S S S S S S S S S S
B B B B B B B B B B B B B W S S S S S S S S S S S S S S S S S S S S S S S S S S S S S S S S S S S S S S S S S S
B B B B B B B B B B B B B W S S S S S S S S S S S S S S S S S S S S S S S S S S S S S S S S S S S S S S S S S S
B B B B B B B B B B B B B W S S S S S S S S S S S S S S S S S S S S S S S S S S S S S S S S S S S S S S S S S S
B B B B B B B B B B B B B W S S S S S S S S S S S S S S S S S S S S S S S S S S S S S S S S S S S S S S S S S S
B B B B B B B B B B B B B W S S S S S S S S S S S S S S S S S S S S S S S S S S S S S S S S S S S S S S S S S S
B B B B B B B B B B B B B W S S S S S S S S S S S S S S S S S S S S S S S S S S S S S S S S S S S S S S S S S S
w W W W W W W W W W W W W W S S S S S S S S S S S S S S S S S S S S S S S S S S S S S S S S S S S S S S S S S S
S S S S S S S S S S S S S S S S S S S S S S S S S S S S S S S S S S S S S S S S S S S S S S S S S S S S S S S S
S S S S S S S S S S S S S S S S S S S S S S S S S S S S S S S S S S S S S S S S S S S S S S S S S S S S S S S S
S S S S S S S S S S S S S S S S S S S S S S S S S S S S S S S S S S S S S S S S S S S S S S S S S S S S S S S S
S S S S S S S S S S S S S S S S S S S S S S S S S S S S S S S S S S S S S S S S S S S S S S S S S S S S S S S S
S S S S S S S S S S S S S S S S S S S S S S S S S S S S S S S S S S S S S S S S S S S S S S S S S S S S S S S S
S S S S S S S S S S S S S S S S S S S S S S S S S S S S S S S S S S S S S S S S S S S S S S S S S S S S S S S S
S S S S S S S S S S S S S S S S S S S S S S S S S S S S S S S S S S S S S S S S S S S S S S S S S S S S S S S S
S S S S S S S S S S S S S S S S S S S S S S S S S S S S S S S S S S S S S S S S S S S S S S S S S S S S S S S S
S S S S S S S S S S S S S S S S S S S S S S S S S S S S S S S S S S S S S S S S S S S S S S S S S S S S S S S S
S S S S S S S S S S S S S S S S S S S S S S S S S S S S S S S S S S S S S S S S S S S S S S S S S S S S S S S S
S S S S S S S S S S S S S S S S S S S S S S S S S S S S S S S S S S S S S S S S S S S S S S S S S S S S S S S S
S S S S S S S S S S S S S S S S S S S S S S S S S S S S S S S S S S S S S S S S S S S S S S S S S S S S S S S S
S S S S S S S S S S S S S S S S S S S S S S S S S S S S S S S S S S S S S S S S S S S S S S S S S S S S S S S S
S S S S S S S S S S S S S S S S S S S S S S S S S S S S S S S S S S S S S S S S S S S S S S S S S S S S S S S S
S S S S S S S S S S S S S S S S S S S S S S S S S S S S S S S S S S S S S S S S S S S S S S S S S S S S S S S S
S S S S S S S S S S S S S S S S S S S S S S S S S S S S S S S S S S S S S S S S S S S S S S S S S S S S S S S S
S S S S S S S S S S S S S S S S S S S S S S S S S S S S S S S S S S S S S S S S S S S S S S S S S S S S S S S S
S S S S S S S S S S S S S S S S S S S S S S S S S S S S S S S S S S S S S S S S S S S S S S S S S S S S S S S S
S S S S S S S S S S S S S S S S S S S S S S S S S S S S S S S S S S S S S S S S S S S S S S S S S S S S S S S S
S S S S S S S S S S S S S S S S S S S S S S S S S S S S S S S S S S S S S S S S S S S S S S S S S S S S S S S S
S S S S S S S S S S S S S S S S S S S S S S S S S S S S S S S S S S S S S S S S S S S S S S S S S S S S S S S S
S S S S S S S S S S S S S S S S S S S S S S S S S S S S S S S S S S S S S S S S S S S S S S S S S S S S S S S S
S S S S S S S S S S S S S S S S S S S S S S S S S S S S S S S S S S S S S S S S S S S S S S S S S S S S S S S S
S S S S S S S S S S S S S S S S S S S S S S S S S S S S S S S S S S S S S S S S S S S S S S S S S S S S S S S S
S S S S S S S S S S S S S S S S S S S S S S S S S S S S S S S S S S S S S S S S S S S S S S S S S S S S S S S S
S S S S S S S S S S S S S S S S S S S S S S S S S S S S S S S S S S S S S S S S S S S S S S S S S S S S S S S S
S S S S S S S S S S S S S S S S S S S S S S S S S S S S S S S S S S S S S S S S S S S S S S S S S S S S S S S S S
