B B B B B B B B B B B B B W S S S S S S S S S S S S S S S S S S S S S S S S S S S S S S S S S S S S S S S S S S
B B B B B B B B B B B B B W S S S S S S S S S S S S S S S S S S S S S S S S S S S S S S S S S S S S S S S S S S
B B B B B B B B B B B B B W S S S S S S S S S S S S S S S S S S S S S S S S S S S S S S S S S S S S S S S S S S
B B B B B B B B B B B B B W S S E S S S S S S S S S S S S S S S S S S S S S S S S S S S S S S S S S S S S S S S
B B B B B B B B B B B B B W S S S S S S S S S S S S S S S S S S S S S S S S S S S S S S S S S S S S S S S S S S
B B B B B B B B B B B B B W S S S S S S S S S S S S S S S S S S S S S S S S S S S S S S S S S S S S S S S S S S
B B B B B B B B B B B B B W S S S S S S S S S S S S S S S S S S S S S S S S S S S S S S S S S S S S S S S S S S
B B B B B B B B B B B B B W S S S S S S S S S S S S S S S S S S S S S S S S S S S S S S S S S S S S S S S S S S
B B B B B B B B B B B B B D S S S S S S S S S S S S S S S S S S S S S S S S S S S S S S S S S S S S S S S S S S
B B B B B B B B B B B B B W S S S S S S S S S S S S S S S S S S S S S S S S S S S S S S S S S S S S S S S S S S
B B B B B B B B B B B B B W S S S S S S S S S S S S S S S S S S S S S S S S S S S S S S S S S S S S S S S S S S
B B B B B B B B B B B B B W S S S S S S S S S S S S S S S S S S S S S S S S S S S S S S S S S S S S S S S S S S
W W W W W W W W W W W W W W S S S S S S S S S S S S S S S S S S S S S S S S S S S S S S S S S S S S S S S S S S
S S S S S S S S S S S S S S S S S S S S S S S S S S S S S S S S S S S S S S S S S S S S S S S S S S S S S S S S
S S S S S S S S S S S S S S S S S S S S S S S S S S S S S S S S S S S S S S S S S S S S S S S S S S S S S S S S
S S S S S S S S S S S S S S S S S S S S S S S S S S S S S S S S S S S S S S S S S S S S S S S S S S S S S S S S
S S S S S S S S S S S S S S S S S S S S S S S S S S S S S S S S S S S S S S S S S S S S S S S S S S S S S S S S
S S S S S S S S S S S S S S S S S S S S S S S S S S S S S S S S S S S S S S S S S S S S S S S S S S S S S S S S
S S S S S S S S S S S S S S S S S S S S S S S S S S S S S S S S S S S S S S S S S S S S S S S S S S S S S S S S
S S S S S S S S S S S S S S S S S S S S S S S S S S S S S S S S S S S S S S S S S S S S S S S S S S S S S S S S
S S S S S S S S S S S S S S S S S S S S S S S S S S S S S S S S S S S S S S S S S S S S S S S S S S S S S S S S
S S S S S S S S S S S S S S S S S S S S S S S S S S S S S S S S S S S S S S S S S S S S S S S S S S S S S S S S
S S S S S S S S S S S S S S S S S S S S S S S S S S S S S S S S S S S S S S S S S S S S S S S S S S S S S S S S
S S S S S S S S S S S S S S S S S S S S S S S S S S S S S S S S S S S S S S S S S S S S S S S S S S S S S S S S
S S S S S S S S S S S S S S S S S S S S S S S S S S S S S S S S S S S S S S S S S S S S S S S S S S S S S S S S
S S S S S S S S S S S S S S S S S S S S S S S S S S S S S S S S S S S S S S S S S S S S S S S S S S S S S S S S
S S S S S S S S S S S S S S S S S S S S S S S S S S S S S S S S S S S S S S S S S S S S S S S S S S S S S S S S
S S S S S S S S S S S S S S S S S S S S S S S S S S S S S S S S S S S S S S S S S S S S S S S S S S S S S S S S
S S S S S S S S S S S S S S S S S S S S S S S S S S S S S S S S S S S S S S S S S S S S S S S S S S S S S S S S
S S S S S S S S S S S S S S S S S S S S S S S S S S S S S S S S S S S S S S S S S S S S S S S S S S S S S S S S
S S S S S S S S S S S S S S S S S S S S S S S S S S S S S S S S S S S S S S S S S S S S S S S S S S S S S S S S
S S S S S S S S S S S S S S S S S S S S S S S S S S S S S S S S S S S S S S S S S S S S S S S S S S S S S S S S
S S S S S S S S S S S S S S S S S S S S S S S S S S S S S S S S S S S S S S S S S S S S S S S S S S S S S S S S
S S S S S S S S S S S S S S S S S S S S S S S S S S S S S S S S S S S S S S S S S S S S S S S S S S S S S S S S
S S S S S S S S S S S S S S S S S S S S S S S S S S S S S S S S S S S S S S S S S S S S S S S S S S S S S S S S
S S S S S S S S S S S S S S S S S S S S S S S S S S S S S S S S S S S S S S S S S S S S S S S S S S S S S S S S
S S S S S S S S S S S S S S S S S S S S S S S S S S S S S S S S S S S S S S S S S S S S S S S S S S S S S S S S
S S S S S S S S S S S S S S S S S S S S S S S S S S S S S S S S S S S S S S S S S S S S S S S S S S S S S S S S
S S S S S S S S S S S S S S S S S S S S S S S S S S S S S S S S S S S S S S S S S S S S S S S S S S S S S S S S
S S S S S S S S S S S S S S S S S S S S S S S S S S S S S S S S S S S S S S S S S S S S S S S S S S S S S S S S S
