I I I I I I I I I I I I I W S S S S S S S S S S S S S S S S S S S S S S S S S S S S S S S S S S S S S S S S S S
I I I I I I I I W I I I I W S S S S S S S S S S S S S S S S S S S S S S S S S S S S S S S S S S S S S S S S S S
I I I I I I I I I I I I I W S S S S S S S S S S S S S S S S S S S S S S S S S S S S S S S S S S S S S S S S S S
I I I I I I I I I I I I I W S S S S S S S S S S S S S S S S S S S S S S S S S S S S S S S S S S S S S S S S S S
I I I I I I I I I I I I I W S S S S S S S S S S S S S S S S S S S S S S S S S S S S S S S S S S S S S S S S S S
I I W I I I I I S I I I I W S S S S S S S S S S S S S S S S S S S S S S S S S S S S S S S S S S S S S S S S S S
I I I I I I I I I I I I I W S S S S S S S S S S S S S S S S S S S S S S S S S S S S S S S S S S S S S S S S S S
I I I I I I I I I I I I W W S S S S S S S S S S S S S S S S S S S S S S S S S S S S S S S S S S S S S S S S S S
I I I I I I I I I I I I I S S S S S S S S S S S S S S S S S S S S S S S S S S S S S S S S S S S S S S S S S S S
I I I I I I I I I I I I I W S S S S S S S S S S S S S S S S S S S S S S S S S S S S S S S S S S S S S S S S S S
I I W I I I I I I I W I I W S S S S S S S S S S S S S S S S S S S S S S S S S S S S S S S S S S S S S S S S S S
I I I I I I I I W I I I I W S S S S S S S S S S S S S S S S S S S S S S S S S S S S S S S S S S S S S S S S S S
W W W W W W W W W W W W W W S S S S S S S S S S S S S S S S S S S S S S S S S S S S S S S S S S S S S S S S S S
S S S S S S S S S S S S S S S S S S S S S S S S S S S S S S S S S S S S S S S S S S S S S S S S S S S S S S S S
S S S S S S S S S S S S S S S S S S S S S S S S S S S S S S S S S S S S S S S S S S S S S S S S S S S S S S S S
S S S S S S S S S S S S S S S S S S S S S S S S S S S S S S S S S S S S S S S S S S S S S S S S S S S S S S S S
S S S S S S S S S S S S S S S S S S S S S S S S S S S S S S S S S S S S S S S S S S S S S S S S S S S S S S S S
S S S S S S S S S S S S S S S S S S S S S S S S S S S S S S S S S S S S S S S S S S S S S S S S S S S S S S S S
S S S S S S S S S S S S S S S S S S S S S S S S S S S S S S S S S S S S S S S S S S S S S S S S S S S S S S S S
S S S S S S S S S S S S S S S S S S S S S S S S S S S S S S S S S S S S S S S S S S S S S S S S S S S S S S S S
S S S S S S S S S S S S S S S S S S S S S S S S S S S S S S S S S S S S S S S S S S S S S S S S S S S S S S S S
S S S S S S S S S S S S S S S S S S S S S S S S S S S S S S S S S S S S S S S S S S S S S S S S S S S S S S S S
S S S S S S S S S S S S S S S S S S S S S S S S S S S S S S S S S S S S S S S S S S S S S S S S S S S S S S S S
S S S S S S S S S S S S S S S S S S S S S S S S S S S S S S S S S S S S S S S S S S S S S S S S S S S S S S S S
S S S S S S S S S S S S S S S S S S S S S S S S S S S S S S S S S S S S S S S S S S S S S S S S S S S S S S S S
S S S S S S S S S S S S S S S S S S S S S S S S S S S S S S S S S S S S S S S S S S S S S S S S S S S S S S S S
S S S S S S S S S S S S S S S S S S S S S S S S S S S S S S S S S S S S S S S S S S S S S S S S S S S S S S S S
S S S S S S S S S S S S S S S S S S S S S S S S S S S S S S S S S S S S S S S S S S S S S S S S S S S S S S S S
S S S S S S S S S S S S S S S S S S S S S S S S S S S S S S S S S S S S S S S S S S S S S S S S S S S S S S S S
S S S S S S S S S S S S S S S S S S S S S S S S S S S S S S S S S S S S S S S S S S S S S S S S S S S S S S S S
S S S S S S S S S S S S S S S S S S S S S S S S S S S S S S S S S S S S S S S S S S S S S S S S S S S S S S S S
S S S S S S S S S S S S S S S S S S S S S S S S S S S S S S S S S S S S S S S S S S S S S S S S S S S S S S S S
S S S S S S S S S S S S S S S S S S S S S S S S S S S S S S S S S S S S S S S S S S S S S S S S S S S S S S S S
S S S S S S S S S S S S S S S S S S S S S S S S S S S S S S S S S S S S S S S S S S S S S S S S S S S S S S S S
S S S S S S S S S S S S S S S S S S S S S S S S S S S S S S S S S S S S S S S S S S S S S S S S S S S S S S S S
S S S S S S S S S S S S S S S S S S S S S S S S S S S S S S S S S S S S S S S S S S S S S S S S S S S S S S S S
S S S S S S S S S S S S S S S S S S S S S S S S S S S S S S S S S S S S S S S S S S S S S S S S S S S S S S S S
S S S S S S S S S S S S S S S S S S S S S S S S S S S S S S S S S S S S S S S S S S S S S S S S S S S S S S S S
S S S S S S S S S S S S S S S S S S S S S S S S S S S S S S S S S S S S S S S S S S S S S S S S S S S S S S S S
S S S S S S S S S S S S S S S S S S S S S S S S S S S S S S S S S S S S S S S S S S S S S S S S S S S S S S S S S
