W W S S S S S S S S S S S W W W W S S S S S S S S S W W
W W S S S S S S J S S S S W W W W W W W S W W W S S W W
W W W W W W W W W W W W W W W W W S S S S W S S S S W W
W W S S S S S S S S S S S W W W W S S W S W W W S S W W
W W S J S S S S S S S S S W W W W S S W S S S W S S W W
W W W W W W W W W W W W W W W W W S S W W W S W W S W W
W W S S S S S S S S S S S W W W W W W W S W S S W S W W
W W S S S S S S S J S S S S S S W S S S S W W B W S W W
W W W W W W W W W W W W W S S S S S W S S S W W W S W W 
W W S S S S S S S S J S S W W W W W W S W S S S S S S D
W W J S S S S S S S S S S W W W S W S S W W W S S S W W
W W W W W W W W W W W W W W W W S W S W W S W W S S W W
W W S S S S S S S S J S S W W W S W S W S S S W S W W W
W W S S S S S B S S S S S W W W S W S W W W S W S W W W
W W S S S S S S S S S S S W W W S W S S S W S W S W W W
W W W W W W W W W W W W W W W W S W W W S W S W S W W W
W W W W W W W W W W W W W W W W S S S W S W S W S W W W
S S S S S S S S S S S S S S S S S W S W S W S W S W W W
S S S W W W S S S S S S S S S S W W W W S W S W S W W W
S S S W B W S S W W W W W W W W W S S S S S S W S W W W
S S S W S W W W W S S S S S S S S S W W W W W W S W W W
S S S W S S S S W W W W W W W W W W W S S S S S S W W W
S S S W W W W S S S S S S S S S S S S S W W W W W W W W 
S S S W W W W W W W W W W W W W W W W W W W W W W W W W W
