W W W W W W W W W W W W W W W W W W W W W W W W W W W W
W S J W S J W S S S S S S S S S S S S S S S S S S S S W
W W W W J S W W W W W W W W W W W W W W W W W W W W S W
_ _ _ W W W W W _ _ _ _ _ _ _ _ _ _ _ _ _ _ _ _ _ W S W
_ _ W W S S S W W _ _ _ _ _ _ _ _ _ _ _ _ _ _ _ _ W S W
_ _ W S S S S S W _ _ W W W W W _ _ _ _ _ _ _ _ _ W W W
_ _ W S S S S S W _ _ W C B C W _ _ _ _ _ _ _ _ _ W D W
_ _ W S S C S S W _ _ W W S W W _ _ _ _ _ _ _ _ _ W S W
_ _ W S S S S S W _ _ W C S C W W W W W W W W W W W S W
_ _ W C W C W C W _ _ W C C S S S S S S S S S S S S S W
_ _ W S W S W S W _ _ W C C C W W W S S S S S S S S S W
_ _ W S W S W S W _ _ W C S C W _ W S S S S S S S S S W
_ _ W S W S W S W _ _ W W S W W _ W S S S S S S S S S W
_ _ W S W S W S W _ _ W C B C W _ W S S S S S S S S S W
_ _ W S W S W S W _ _ W W W W W _ W S S S S S S S S S W
_ _ W S W S W W W _ _ _ _ _ _ _ _ W W W W W S W W W W W
_ _ W S W S W _ _ _ _ _ _ _ _ _ _ _ _ _ _ _ W S W _ _ _
_ _ W S W S W _ _ _ _ _ _ _ _ _ _ _ _ _ _ _ W S W _ _ _
_ _ W W W S W _ _ _ _ _ _ _ _ _ _ _ W W W W W S W W W _
_ _ _ _ W S W _ _ _ _ _ _ _ _ _ _ _ W S W S W S W S W _
_ _ _ _ W S W _ _ _ _ _ _ _ _ _ _ _ W S W S W S W S W _
_ _ _ _ W S W _ _ _ _ _ _ _ _ _ _ _ W S W S W S W S W _
_ _ _ _ W S W _ W W W W W W W W W W W S W S W S W S W _
_ _ _ _ W S W _ W S S S S C S S S S S S W S W S W S W _
_ _ _ _ W S W _ W S S S S W W W W W W W W S W S W S W _
_ _ _ _ W S W W W S S S S C S S S S S S S S W S W S W _
_ _ _ _ W S S S S S S S S W W W W W W W W W W S W S W _
_ _ _ _ W W W W W S S C S C S S S S S S S S S S W S W _
_ _ _ _ _ _ _ _ W S S S S W W W W W W W W W W W W S W _
_ _ _ _ _ _ _ _ W S S S S C S S S S S S S S S S S S W _
_ _ _ _ _ _ _ _ W W W W W W W W W W W W W W W W W W W _
